{
    "nivel": 20,
    "nombre": "Nivel 20",
    "mapa": [
        "1,1,1,1,1,1,1,1,1,1,1,1,1,1,1,1,1,1,1,1",
        "1,S,o,0,0,0,0,1,0,0,0,0,0,0,0,0,0,0,m,1",
        "1,1,1,1,1,1,0,1,0,1,f,1,1,1,1,1,1,1,1,1",
        "1,0,0,0,0,1,0,1,0,1,0,o,o,o,o,o,o,o,Z,1",
        "1,0,1,1,0,1,0,1,0,1,0,1,1,1,1,1,1,1,1,1",
        "1,0,1,m,0,1,0,1,0,1,0,1,0,0,0,0,0,0,0,1",
        "1,0,1,0,1,1,0,1,0,1,0,1,0,1,1,1,1,1,0,1",
        "1,0,1,0,0,0,0,1,0,1,0,1,0,1,0,0,0,1,0,1",
        "1,o,1,1,1,1,1,1,0,1,0,1,0,1,0,1,0,1,0,1",
        "1,o,o,o,o,o,Z,o,0,0,0,0,0,1,0,1,0,1,0,1",
        "1,1,1,1,1,1,1,1,1,1,0,1,0,1,0,1,0,1,0,1",
        "1,m,0,0,0,0,0,0,0,0,0,1,0,1,m,1,0,0,0,1",
        "1,1,1,1,1,0,1,1,1,1,1,1,0,1,1,1,0,1,1,1",
        "1,0,0,0,0,0,0,0,0,0,0,1,0,0,0,0,0,0,1,1",
        "1,0,1,1,1,f,1,1,1,1,0,1,1,1,1,1,1,0,0,1",
        "1,0,1,0,0,0,0,0,0,1,0,0,0,0,0,0,0,0,0,1",
        "1,0,1,0,1,0,1,1,0,1,1,1,1,1,1,1,1,1,0,1",
        "1,0,1,0,1,m,0,1,0,1,0,0,0,0,0,0,0,0,0,1",
        "1,0,1,0,1,1,0,1,0,1,0,1,0,1,1,1,1,1,o,1",
        "1,0,1,0,0,0,0,1,0,1,0,1,0,0,0,0,0,1,o,1",
        "1,0,1,1,1,1,1,1,f,1,0,1,0,1,1,1,0,1,o,1",
        "1,0,0,0,0,0,0,0,0,1,0,1,0,1,o,1,0,1,o,1",
        "1,1,1,1,1,1,1,1,1,1,0,1,0,1,1,1,0,1,o,1",
        "1,0,0,0,0,0,0,0,0,0,0,0,0,0,0,0,0,1,o,1",
        "1,0,1,1,1,1,1,1,1,1,1,1,1,1,1,1,1,1,o,1",
        "1,0,1,W,o,o,o,o,o,o,o,o,o,o,o,o,o,o,o,1",
        "1,0,1,1,1,1,1,1,1,1,1,1,1,1,1,1,1,1,1,1",
        "1,0,0,0,0,0,0,0,0,0,0,0,0,0,0,0,0,0,0,1",
        "1,P,o,1,1,1,1,1,1,1,1,1,1,1,1,1,1,1,1,1",
        "1,1,1,1,1,1,1,1,1,1,1,1,1,1,1,1,1,1,1,1"
    ]
}