{
    "nivel": 11,
    "nombre": "Nivel 11 - Pac Man",
    "mapa": [
        "1,1,1,1,1,1,1,1,1,1,1,1,1,1,1,1,1,1,1,1,1,1,1,1,1,1,1,1,1,1,1,1,1,1,1",
        "1,1,1,1,1,1,1,0,0,0,0,1,1,1,1,0,0,0,0,0,0,0,0,0,0,0,0,0,0,0,0,0,0,0,1",
        "1,0,0,0,0,0,0,0,1,1,0,0,0,0,0,0,1,1,1,1,1,1,1,1,1,1,1,1,1,1,1,1,1,0,1",
        "1,0,1,1,1,1,1,1,1,1,1,1,1,1,1,0,1,1,m,0,0,0,0,0,0,0,0,0,0,0,0,m,1,0,1",
        "1,0,1,0,0,0,0,m,1,1,1,1,1,1,1,m,1,1,0,1,1,1,1,1,1,1,1,1,1,1,1,0,1,0,1",
        "1,0,1,0,1,1,1,0,1,o,o,o,o,o,o,o,o,o,o,o,o,o,o,o,o,o,o,Z,1,0,0,0,1,0,1",
        "1,o,o,o,o,Z,o,o,1,o,1,o,o,o,1,o,1,1,o,1,o,o,1,o,o,o,1,o,1,0,1,1,1,0,1",
        "1,1,1,1,1,1,0,1,1,o,1,o,o,o,1,o,1,o,o,o,1,o,1,o,o,o,1,o,1,0,0,0,1,0,1",
        "1,1,0,0,0,0,m,0,0,o,1,o,o,o,1,o,1,o,S,o,1,o,1,o,o,o,1,o,1,1,1,0,1,0,1",
        "1,1,0,1,1,1,0,1,1,o,1,o,o,o,1,o,1,o,o,o,1,o,1,o,o,o,1,o,0,0,1,0,1,0,1",
        "1,1,0,1,1,1,0,1,1,o,o,1,1,1,o,o,1,1,1,1,o,o,o,1,1,1,o,o,1,0,1,0,1,0,1",
        "1,1,0,1,1,1,0,1,1,Z,o,o,o,o,o,o,o,o,o,o,o,o,o,o,o,o,o,o,1,0,1,0,1,0,1",
        "1,1,0,1,1,1,0,1,1,1,1,1,1,1,1,1,1,1,1,1,1,1,1,1,1,1,1,1,1,0,1,m,0,0,1",
        "1,1,0,1,1,1,0,o,o,o,Z,o,o,o,1,0,0,0,0,0,0,m,1,o,o,o,o,Z,o,0,1,1,1,1,1",
        "1,1,0,1,0,0,0,1,1,1,1,1,1,1,1,0,o,o,o,o,o,0,1,1,1,1,1,1,1,0,0,1,1,1,1",
        "1,1,0,1,0,1,1,1,0,0,0,0,0,0,0,0,0,0,P,0,0,0,0,0,0,0,1,1,1,1,0,1,1,1,1",
        "1,0,0,1,0,0,0,0,0,1,1,1,1,1,1,1,1,1,1,1,1,1,1,0,0,0,0,0,0,0,m,1,1,1,1",
        "1,0,1,1,0,1,1,1,1,1,1,1,1,1,1,o,o,o,o,o,o,o,1,1,1,1,1,1,1,1,o,1,1,1,1",
        "1,m,0,0,0,1,o,o,o,o,o,o,o,o,Z,o,o,o,o,o,o,o,o,o,o,o,o,o,o,o,o,1,1,1,1",
        "1,1,1,1,1,1,1,1,1,1,1,1,1,1,1,1,1,1,1,1,1,1,1,1,1,1,1,1,1,1,1,1,1,1,1"
    ]
}