{
    "nivel": 16,
    "nombre": "Nivel 16 - El Despertar del Vacio",
    "mapa": [
        "1,1,1,1,1,1,1,1,1,1,1,S,1,1,1,1,1,1,1,1,1,1,1",
        "1,o,o,o,o,o,o,o,o,o,0,0,0,o,o,o,o,o,o,o,o,o,1",
        "1,0,o,o,1,o,o,o,o,o,1,o,o,o,o,o,o,o,o,o,1,0,1",
        "1,0,o,o,o,o,o,o,o,o,o,o,o,o,o,o,o,o,o,o,o,0,1",
        "1,o,o,o,o,1,1,1,1,1,1,o,o,o,o,Z,o,o,o,0,1,0,1",
        "1,1,1,1,o,o,o,o,o,o,o,o,o,o,o,o,o,o,o,0,1,o,1",
        "1,1,o,o,f,1,o,o,o,o,o,o,1,o,o,o,o,o,o,0,o,o,1",
        "1,1,o,o,1,1,o,o,o,1,f,o,f,o,0,0,0,o,o,o,o,o,1",
        "1,o,o,1,1,1,1,o,o,1,0,1,1,1,1,1,1,1,1,1,1,1,1",
        "1,o,o,0,0,0,1,1,1,1,0,0,0,0,0,0,0,0,0,0,0,0,1",
        "1,1,1,1,1,0,0,0,0,0,0,1,1,1,1,1,1,1,1,o,1,0,1",
        "1,0,0,0,0,0,1,1,1,1,1,1,o,o,o,o,o,o,o,o,1,0,1",
        "1,0,1,1,1,1,1,0,0,0,1,1,o,o,o,o,o,o,o,Z,1,0,1",
        "1,0,0,0,0,0,0,0,1,0,0,1,o,o,1,o,o,o,o,o,1,0,1",
        "1,1,1,1,1,1,1,1,1,1,0,1,Z,o,o,o,o,o,o,o,1,0,1",
        "1,0,0,0,0,0,0,0,0,0,0,1,o,o,o,o,o,1,1,1,1,0,1",
        "1,0,1,1,1,1,1,1,1,1,1,1,1,1,o,o,o,1,0,0,0,0,1",
        "1,0,0,0,0,0,0,0,0,0,0,0,0,1,o,1,1,1,0,1,1,1,1",
        "1,m,1,1,1,1,0,1,1,1,1,1,0,1,0,0,0,1,0,0,0,0,1",
        "1,1,1,m,0,0,0,1,1,1,1,1,0,1,0,1,0,1,1,1,1,0,1",
        "1,0,0,0,1,1,1,1,o,o,0,0,0,1,0,1,0,0,0,0,1,0,1",
        "1,0,0,0,0,0,0,0,o,o,1,T,o,1,0,1,1,1,o,0,1,0,1",
        "1,1,1,1,1,1,1,1,1,0,1,1,W,1,0,0,0,0,0,0,1,0,1",
        "1,0,0,0,0,0,0,0,0,0,1,1,1,1,1,f,1,1,1,1,1,0,1",
        "1,f,1,1,1,1,1,1,1,1,1,0,0,0,0,0,1,0,0,0,0,0,1",
        "1,0,0,0,0,0,0,0,1,1,1,0,1,1,1,1,1,f,1,1,1,1,1",
        "1,1,1,1,1,1,0,0,0,0,0,0,1,Z,o,o,o,0,0,0,m,1,1",
        "1,Z,o,o,o,o,o,1,1,1,1,1,1,1,1,o,1,0,1,1,0,1,1",
        "1,1,o,1,1,1,1,1,1,o,o,o,o,o,1,o,1,0,1,1,0,1,1",
        "1,1,o,o,o,o,o,o,o,o,o,P,o,o,o,o,1,0,0,0,0,1,1",
        "1,1,1,1,1,1,1,1,1,1,1,1,1,1,1,1,1,1,1,1,1,1,1"
    ],
    "mensajes": [
        {
            "text": "{purple}The Void Galaxy{purple}"
        }
    ]
}