{
    "nivel": 11,
    "nombre": "Nivel 11 - 2 Caminos",
    "mapa": [
        "1,1,1,1,1,1,1,1,1,1,1,1,1",
        "1,o,o,o,0,0,0,0,m,1,o,o,1",
        "1,o,P,o,1,1,1,1,0,1,o,o,1",
        "1,1,1,1,1,0,0,0,0,0,o,Z,1",
        "1,m,0,0,0,0,1,1,1,1,o,o,1",
        "1,0,1,1,1,1,m,0,0,0,1,0,1",
        "1,0,0,0,0,1,0,1,1,0,1,0,1",
        "1,1,1,1,0,1,0,Z,o,0,1,0,1",
        "1,1,0,0,0,1,0,0,1,0,1,0,1",
        "1,1,0,1,1,1,1,0,1,0,0,0,1",
        "1,0,0,1,Z,o,o,0,1,1,1,1,1",
        "1,0,1,1,1,1,1,0,0,0,0,m,1",
        "1,0,1,m,0,0,1,1,1,1,1,0,1",
        "1,0,1,0,1,0,1,0,0,0,0,0,1",
        "1,0,0,0,1,0,1,0,1,1,1,1,1",
        "1,1,1,1,1,0,1,0,0,0,0,m,1",
        "1,o,o,o,o,o,1,1,1,1,1,0,1",
        "1,o,o,Z,1,1,1,o,o,o,0,0,1",
        "1,o,o,o,1,1,1,o,S,o,1,1,1",
        "1,1,1,1,1,1,1,1,1,1,1,1,1"
    ]
}