{
    "nivel": 7,
    "nombre": "Nivel 7 - The labyrinth of strategy",
    "mapa": [
        "1,1,1,1,1,1,1,1,1,1,1,1,1,1,1,1,1,1,1,1",
        "1,0,0,0,0,0,0,0,0,0,0,0,0,0,0,1,o,o,o,1",
        "1,0,1,o,o,o,o,o,o,o,1,o,o,o,0,o,o,Z,o,1",
        "1,1,0,0,m,m,m,m,m,0,0,0,0,0,m,o,o,o,o,1",
        "1,0,0,0,0,1,1,1,1,1,m,o,o,1,m,o,0,o,0,1",
        "1,0,0,o,1,1,Z,o,o,1,0,0,0,0,m,0,0,0,0,1",
        "1,0,0,o,o,S,1,o,o,m,m,m,m,m,0,0,0,0,0,1",
        "1,0,1,o,1,1,o,o,Z,1,0,o,o,0,1,o,0,o,1,1",
        "1,0,0,0,0,1,1,1,1,1,0,o,1,0,m,m,m,0,0,1",
        "1,0,0,0,0,0,0,0,0,1,0,0,o,0,o,o,0,o,0,1",
        "1,0,0,1,0,0,0,0,0,1,1,0,o,o,o,Z,0,0,0,1",
        "1,1,1,1,1,1,1,1,1,1,1,1,1,1,1,1,1,1,1,1"
    ]
}