{
    "nivel": 9,
    "nombre": "Nivel 9 - The Tactical Hallways",
    "mapa": [
        "1,1,1,1,1,1,1,1,1,1,1,1,1,1,1,1,1,1,1,1",
        "1,0,0,0,0,0,0,0,0,0,0,0,0,0,0,1,o,o,S,1",
        "1,1,1,1,1,1,1,o,1,o,o,o,o,o,0,1,o,o,o,1",
        "1,1,m,0,0,1,1,1,0,0,0,0,1,o,0,1,o,1,1,1",
        "1,1,m,1,0,1,1,1,m,0,m,0,m,0,0,o,o,o,Z,1",
        "1,1,m,1,0,1,1,o,o,o,o,0,o,o,1,o,0,1,0,1",
        "1,1,0,1,0,0,0,0,0,0,0,m,0,0,0,0,0,o,0,1",
        "1,1,0,1,1,1,1,o,o,o,o,m,o,o,1,1,1,0,0,1",
        "1,Z,0,o,o,o,o,o,o,o,o,0,0,0,0,0,0,0,1,1",
        "1,1,0,1,1,1,1,1,1,1,1,1,1,1,1,1,1,1,1,1",
        "1,1,0,1,1,1,1,1,1,1,1,1,1,1,1,1,1,1,1,1",
        "1,1,0,1,1,1,1,1,1,1,1,1,1,1,1,1,1,1,1,1",
        "1,1,0,1,1,1,1,1,1,1,1,1,1,1,1,1,1,1,1,1",
        "1,1,0,1,1,1,1,1,1,1,1,1,1,1,1,1,1,1,1,1",
        "1,1,f,1,1,1,1,1,1,1,1,1,1,1,1,1,1,1,1,1",
        "1,1,0,0,0,0,0,0,0,0,0,0,0,0,0,0,0,0,P,1",
        "1,1,1,1,1,1,1,1,1,1,1,1,1,1,1,1,1,1,1,1"
    ]
}