{
    "nivel": 9,
    "nombre": "Preview(6)",
    "mapa": [
        "1,1,1,1,1,1,1,1,1,1,1",
        "1,0,0,0,0,0,0,0,0,S,1",
        "1,0,1,1,1,1,o,1,1,1,1",
        "1,0,1,0,0,0,0,0,0,0,1",
        "1,0,1,0,1,1,1,1,1,1,1",
        "1,0,1,0,0,0,1,0,0,0,1",
        "1,m,1,1,0,0,0,0,1,0,1",
        "1,m,1,1,1,1,1,1,1,0,1",
        "1,m,1,0,0,0,0,0,0,0,1",
        "1,m,1,0,0,P,0,0,1,0,1",
        "1,m,1,1,1,1,1,1,1,0,1",
        "1,0,1,Z,o,o,m,m,1,0,1",
        "1,0,1,o,o,1,0,0,1,0,1",
        "1,0,1,1,1,1,0,0,0,0,1",
        "1,0,0,0,0,1,1,0,1,1,1",
        "1,1,1,1,0,0,1,0,1,0,1",
        "1,0,0,0,0,0,1,0,1,0,1",
        "1,0,0,0,0,0,0,0,1,0,1",
        "1,0,0,1,1,1,0,0,0,0,1",
        "1,1,1,1,1,1,1,1,1,1,1"
    ]
}