{
    "nivel": 10,
    "nombre": "Nivel 10 - hormiguero",
    "mapa": [
        "1,1,1,1,1,1,1,1,1,1,1,1,1,1,1,1,1,1,1,1",
        "1,S,o,o,o,o,o,o,o,o,o,o,o,o,o,o,o,o,o,1",
        "1,1,1,1,1,1,1,1,1,1,1,1,o,1,1,1,1,1,0,1",
        "1,Z,o,o,o,o,o,o,0,0,0,0,0,1,1,1,1,1,0,1",
        "1,1,1,1,1,1,1,1,m,1,1,1,1,1,1,1,1,1,0,1",
        "1,m,0,0,0,0,0,1,0,0,o,o,o,o,o,o,Z,1,m,1",
        "1,0,1,Z,o,o,0,1,1,0,1,1,1,1,1,1,1,1,m,1",
        "1,0,1,1,1,1,0,0,0,0,1,1,Z,o,o,o,o,o,m,1",
        "1,0,0,0,0,1,1,1,1,1,1,1,1,1,1,1,0,1,m,1",
        "1,1,1,1,0,0,0,0,0,0,0,0,0,0,m,1,0,1,0,1",
        "1,1,1,1,1,1,1,1,1,1,1,0,0,0,0,1,0,1,0,1",
        "1,o,o,Z,1,0,0,0,0,0,0,0,1,1,1,1,0,1,0,1",
        "1,o,1,1,1,0,1,1,1,1,1,1,1,0,0,0,0,1,1,1",
        "1,o,0,0,0,0,m,0,0,0,0,0,m,0,1,1,0,0,0,1",
        "1,o,1,1,1,0,1,0,o,o,o,0,1,0,1,1,1,1,0,1",
        "1,o,1,1,1,m,1,0,0,P,0,0,1,m,1,0,1,0,0,1",
        "1,o,o,Z,1,m,1,1,1,1,1,1,1,m,1,m,1,0,0,1",
        "1,o,o,o,1,m,0,0,0,1,0,0,0,m,1,m,1,0,1,1",
        "1,o,o,o,1,0,0,0,0,m,0,0,0,0,1,m,1,m,1,1",
        "1,o,o,Z,1,0,0,0,1,0,1,0,0,0,Z,0,1,0,1,1",
        "1,o,1,1,1,1,1,1,1,0,1,1,1,1,1,1,1,0,1,1",
        "1,o,o,o,o,o,Z,1,1,m,1,1,0,0,0,0,0,0,0,1",
        "1,o,1,1,1,1,Z,o,o,0,o,o,0,1,1,1,1,1,1,1",
        "1,o,0,0,0,1,1,1,1,0,1,1,0,1,Z,o,o,o,o,1",
        "1,o,1,1,0,0,0,0,1,0,o,1,0,1,1,1,o,1,m,1",
        "1,1,1,1,0,o,1,0,1,m,o,1,0,0,0,0,0,1,m,1",
        "1,0,0,0,0,0,0,m,1,0,o,1,1,1,1,1,0,1,0,1",
        "1,0,1,1,1,1,1,1,1,0,0,0,0,0,0,o,o,1,m,1",
        "1,0,0,0,m,m,m,0,0,0,1,1,1,1,1,o,o,1,m,1",
        "1,1,1,1,1,1,1,1,1,1,1,1,1,1,1,1,1,1,1,1"
    ]
}