{
    "nivel": 13,
    "nombre": "Nivel 13",
    "mapa": [
        "1,1,1,1,1,1,1,1,1,1,1,1,1,1,1,1,1,1,1,1,1",
        "1,o,o,o,o,o,o,Z,1,0,0,0,1,o,o,o,o,o,Z,o,1",
        "1,1,0,1,1,1,1,1,1,0,1,0,1,1,1,0,1,o,o,o,1",
        "1,1,0,0,0,0,0,0,0,0,1,0,0,0,0,0,1,o,o,o,1",
        "1,0,0,1,1,0,1,1,1,1,1,1,1,1,1,1,1,1,1,1,1",
        "1,0,0,1,1,0,0,0,0,0,0,0,0,0,0,0,0,0,0,0,1",
        "1,o,1,1,1,1,1,1,1,1,1,1,1,1,1,1,1,1,1,0,1",
        "1,o,1,o,o,o,o,o,Z,1,1,1,o,o,o,o,o,Z,1,0,1",
        "1,o,1,0,1,1,1,1,1,1,1,1,1,1,1,0,1,1,1,0,1",
        "1,o,1,0,1,Z,0,0,0,0,0,0,0,0,1,0,1,o,o,o,1",
        "1,1,1,0,1,0,1,1,1,1,o,1,1,1,1,0,1,o,o,1,1",
        "1,m,0,0,1,0,1,o,o,o,o,o,o,Z,1,0,1,o,o,1,1",
        "1,0,o,1,1,0,o,o,o,o,P,o,o,o,o,0,1,1,o,o,1",
        "1,0,0,0,1,0,1,Z,o,o,o,o,o,o,1,0,1,0,o,o,1",
        "1,0,1,0,1,0,1,1,1,1,o,1,1,1,1,1,1,0,1,1,1",
        "1,0,1,0,1,0,1,0,0,0,0,0,0,0,0,0,1,0,1,o,1",
        "1,0,1,0,1,1,1,1,1,1,1,1,1,1,1,0,1,0,1,o,1",
        "1,0,1,o,o,o,o,o,o,o,o,o,o,o,o,o,o,Z,1,o,1",
        "1,0,1,1,1,1,1,1,1,1,1,1,1,1,1,1,1,1,1,o,1",
        "1,0,0,0,0,0,0,1,0,0,0,0,0,0,0,0,1,0,0,o,1",
        "1,1,1,1,1,1,0,1,0,1,o,o,o,Z,o,0,1,0,1,o,1",
        "1,0,0,0,0,o,o,1,0,1,1,1,1,1,1,0,1,0,1,o,1",
        "1,0,1,1,1,o,o,0,0,1,m,0,0,0,0,0,0,0,1,o,1",
        "1,0,0,0,1,1,1,1,1,1,0,1,1,1,1,1,1,1,1,o,1",
        "1,1,1,0,0,0,0,0,0,1,0,0,0,0,1,1,o,o,o,Z,1",
        "1,o,1,1,1,1,1,1,0,1,1,Z,o,0,0,0,0,0,1,1,1",
        "1,o,0,0,0,0,0,0,0,1,1,1,1,1,1,1,1,0,1,1,1",
        "1,o,1,1,1,1,1,1,1,1,1,o,o,o,o,o,o,o,o,o,1",
        "1,o,o,o,o,Z,o,o,o,1,1,o,o,o,o,o,o,o,o,S,1",
        "1,1,1,1,1,1,1,1,1,1,1,1,1,1,1,1,1,1,1,1,1"
    ]
}