{
    "nivel": 8,
    "nombre": "Nivel 8 - The Labyrinth of Mirrors",
    "mapa": [
        "1,1,1,1,1,1,1,1,1,1,1,1,1,1,1,1,1,1,1,1,1,1",
        "1,0,0,0,1,1,0,0,0,0,0,0,0,0,0,1,1,o,o,o,1,1",
        "1,1,0,0,0,0,0,0,0,0,0,0,0,0,0,1,1,o,o,o,1,1",
        "1,1,0,1,1,1,1,1,1,1,1,1,1,1,0,0,1,o,S,o,1,1",
        "1,1,0,0,0,0,0,0,1,0,m,m,Z,1,1,0,1,o,o,o,1,1",
        "1,1,1,1,1,1,1,0,1,Z,m,m,0,1,1,0,1,1,0,1,1,1",
        "1,1,1,1,1,1,1,0,1,1,1,0,1,1,1,0,1,o,o,o,o,1",
        "1,1,1,1,1,1,1,0,1,1,1,0,0,0,0,0,1,o,o,o,o,1",
        "1,1,1,1,1,1,1,0,1,1,1,1,1,1,1,1,1,1,0,1,0,1",
        "1,1,0,0,0,0,0,0,0,0,0,0,0,0,0,0,0,1,0,1,0,1",
        "1,1,0,1,1,1,1,1,1,1,1,1,1,1,1,1,0,1,0,1,0,1",
        "1,1,0,1,1,1,1,o,o,o,o,o,o,o,o,o,0,1,0,1,0,1",
        "1,1,0,0,0,0,1,o,o,o,o,Z,o,o,o,o,0,1,0,1,0,1",
        "1,1,1,1,1,0,1,1,1,1,1,1,1,1,1,1,0,1,0,1,0,1",
        "1,Z,o,o,o,o,o,o,o,o,o,o,o,o,o,o,o,o,o,1,0,1",
        "1,1,1,1,1,1,1,1,1,1,1,1,1,1,1,1,o,1,1,1,o,1",
        "1,1,1,1,1,1,Z,o,o,o,o,o,o,o,o,1,o,o,o,o,o,1",
        "1,1,1,1,1,1,o,o,o,o,o,o,o,o,o,o,o,o,o,o,Z,1",
        "1,1,1,1,1,1,1,1,1,1,1,1,1,1,1,1,1,1,1,1,1,1"
    ]
}