{
    "nivel": 8,
    "nombre": "Preview(5)",
    "mapa": [
        "1,1,1,1,1,1,1,1,1,1,1,1,1,1,1,1,1,1,1,1,1,1,1,1,1,1,1,1,1,1",
        "1,0,0,0,0,0,0,0,0,0,0,0,0,0,0,1,1,1,1,1,1,1,1,0,0,0,0,0,S,1",
        "1,0,0,0,0,0,0,0,0,0,0,0,0,0,0,m,0,m,m,m,0,m,0,0,0,0,0,0,1,1",
        "1,o,o,o,1,1,1,1,1,1,1,1,1,1,1,1,1,1,1,1,1,1,1,1,1,1,1,o,1,1",
        "1,o,o,o,1,0,0,0,0,0,0,0,0,0,0,0,0,0,0,0,0,0,0,0,0,0,0,0,0,1",
        "1,1,o,1,1,0,1,1,1,1,1,1,1,1,1,1,1,1,1,1,1,1,1,0,1,1,1,1,0,1",
        "1,0,0,0,0,0,0,0,0,0,0,0,0,0,0,0,0,0,0,0,0,0,1,0,1,m,m,1,0,1",
        "1,1,o,1,1,1,1,1,1,1,1,1,1,1,1,1,1,1,1,1,1,0,1,0,1,m,m,1,0,1",
        "1,Z,o,o,o,o,o,o,o,o,o,o,Z,1,0,0,0,0,0,0,0,0,1,0,1,0,0,1,0,1",
        "1,1,o,1,1,1,1,1,1,1,1,1,1,1,0,1,1,1,1,1,1,1,1,0,1,o,Z,o,o,1",
        "1,o,0,o,1,o,o,o,1,o,1,o,1,1,0,0,0,0,0,0,1,m,0,0,1,0,0,0,0,1",
        "1,o,m,o,1,o,o,o,o,o,1,o,o,1,0,0,1,1,1,0,1,0,1,0,1,1,1,1,1,1",
        "1,1,0,o,o,o,o,o,o,o,o,o,o,1,1,1,1,1,1,0,1,0,1,0,1,0,0,0,0,1",
        "1,o,o,o,o,o,o,o,o,1,o,o,o,o,o,o,o,o,1,0,1,0,1,1,1,0,1,1,0,1",
        "1,o,o,1,1,1,1,o,o,1,o,o,o,o,o,0,o,o,1,0,1,0,0,0,0,0,0,0,P,1",
        "1,o,o,o,1,o,o,o,m,1,1,1,o,o,o,m,o,o,1,0,1,0,1,1,1,1,1,1,1,1",
        "1,o,o,1,0,o,o,o,1,1,o,o,o,o,o,0,o,o,o,0,1,0,1,Z,o,o,o,o,o,1",
        "1,o,o,o,0,o,o,o,o,o,o,o,o,o,o,o,o,o,o,o,1,0,1,1,1,1,0,1,0,1",
        "1,o,o,Z,0,o,o,1,1,1,o,o,Z,o,o,1,o,o,o,o,1,0,0,0,0,0,m,1,0,1",
        "1,o,o,o,o,o,o,o,o,o,o,o,o,o,o,o,1,1,o,o,1,1,1,1,1,1,1,1,0,1",
        "1,1,o,1,0,0,0,o,o,o,o,o,0,o,o,o,o,o,o,o,o,o,o,o,o,o,o,1,0,1",
        "1,o,o,o,o,o,o,1,o,o,o,o,o,o,o,o,o,o,o,o,o,o,o,o,o,o,0,1,0,1",
        "1,o,o,o,o,1,o,1,o,o,o,o,1,1,o,o,o,o,o,o,o,1,1,o,o,o,0,1,0,1",
        "1,o,o,o,o,1,o,1,o,o,o,o,1,o,0,0,0,m,0,0,0,o,o,o,o,o,0,1,0,1",
        "1,o,o,o,o,1,o,o,o,o,o,o,o,o,o,o,o,o,o,o,o,o,o,o,o,o,o,1,0,1",
        "1,1,o,1,o,1,o,o,o,o,o,o,o,o,o,o,o,o,o,o,o,o,o,o,o,o,o,1,0,1",
        "1,o,o,o,o,1,o,0,0,0,o,o,o,o,o,o,o,o,1,1,1,0,0,0,0,0,0,0,0,1",
        "1,o,o,o,o,o,o,o,o,o,o,o,o,1,1,o,o,o,o,Z,1,1,1,1,1,1,1,1,1,1",
        "1,Z,o,o,o,o,o,o,o,o,o,o,o,1,o,o,o,o,o,o,Z,o,o,o,o,o,o,o,o,1",
        "1,1,1,1,1,1,1,1,1,1,1,1,1,1,1,1,1,1,1,1,1,1,1,1,1,1,1,1,1,1"
    ]
}