{
    "nivel": 15,
    "nombre": "Nivel 15 - Multi Nivel",
    "mapa": [
        "1,1,1,1,1,1,1,1,1,1,o,o,o,1,1,1,1,1,1,1,1,1,1",
        "1,o,o,o,o,o,o,o,1,o,o,o,o,o,1,o,o,o,o,o,o,o,1",
        "1,o,o,o,o,o,o,o,1,o,o,S,o,o,1,o,o,o,o,o,o,o,1",
        "1,o,o,o,o,o,o,o,1,o,o,o,o,o,1,o,o,o,o,o,o,o,1",
        "1,o,o,o,o,o,o,o,1,1,o,o,o,1,1,o,o,o,o,o,o,o,1",
        "1,o,o,o,o,o,o,o,o,o,o,o,o,o,o,o,o,o,o,o,o,Z,1",
        "1,o,o,o,o,o,o,o,o,o,o,o,o,o,o,o,o,o,o,o,o,o,1",
        "1,o,o,o,o,o,o,o,1,1,o,o,o,1,1,o,o,o,o,o,o,o,1",
        "1,o,o,o,o,o,o,o,1,1,o,o,o,1,1,o,o,o,o,o,o,o,1",
        "1,o,o,o,o,o,o,o,1,1,o,o,o,1,1,o,o,o,o,o,o,o,1",
        "1,o,o,o,o,o,o,o,1,1,o,o,o,1,1,o,o,o,o,o,o,o,1",
        "1,o,o,o,o,o,o,o,1,1,o,o,o,1,1,o,o,o,o,o,o,o,1",
        "1,o,o,o,o,o,o,o,1,1,o,o,o,1,1,o,o,o,o,o,o,o,1",
        "1,o,o,o,o,o,o,o,1,1,1,o,1,1,1,o,o,o,o,o,o,o,1",
        "1,o,o,o,o,o,o,o,o,1,1,o,1,1,o,o,o,o,o,o,o,o,1",
        "1,o,o,o,o,o,o,o,o,o,o,o,o,o,o,o,o,o,o,o,o,o,1",
        "1,o,o,o,o,o,o,o,o,o,o,o,o,o,o,o,o,o,o,o,o,Z,1",
        "1,o,o,o,o,o,o,o,1,1,1,o,1,1,o,o,o,o,o,o,o,o,1",
        "1,o,o,o,o,o,o,o,1,1,1,o,1,1,1,o,o,o,o,o,o,o,1",
        "1,o,o,o,o,o,o,o,1,1,o,o,o,1,1,o,o,o,o,o,o,o,1",
        "1,o,o,o,o,o,o,o,1,1,o,o,o,1,1,o,o,o,o,o,o,o,1",
        "1,o,o,o,o,o,o,o,1,1,o,o,o,1,1,o,o,o,o,o,o,o,1",
        "1,o,o,o,o,o,o,o,1,1,o,o,o,1,1,o,o,o,o,o,o,o,1",
        "1,o,o,o,o,o,o,o,1,1,1,o,1,1,1,o,o,o,o,o,o,o,1",
        "1,o,o,o,o,o,o,o,1,1,1,o,1,1,o,o,o,o,o,o,o,o,1",
        "1,o,o,o,o,o,o,o,o,o,o,o,o,o,o,o,o,o,o,o,o,o,1",
        "1,o,o,o,o,o,o,o,o,o,o,o,o,o,o,o,o,o,o,o,o,Z,1",
        "1,o,o,o,o,o,o,o,1,1,o,o,o,1,1,o,o,o,o,o,o,o,1",
        "1,o,o,o,o,o,o,o,1,1,o,o,o,1,1,o,o,o,o,o,o,o,1",
        "1,o,o,o,o,o,o,o,1,1,o,o,o,1,1,o,o,o,o,o,o,o,1",
        "1,o,o,o,o,o,o,o,1,1,o,o,o,1,1,o,o,o,o,o,o,o,1",
        "1,o,o,o,o,o,o,o,1,1,o,o,o,1,1,o,o,o,o,o,o,o,1",
        "1,o,o,o,o,o,o,o,1,1,o,o,o,1,1,o,o,o,o,o,o,o,1",
        "1,o,o,o,o,o,o,o,1,1,1,o,1,1,1,o,o,o,o,o,o,o,1",
        "1,o,o,o,o,o,o,o,o,1,1,o,1,1,o,o,o,o,o,o,o,o,1",
        "1,o,o,o,o,o,o,o,o,o,o,o,o,o,o,o,o,o,o,o,o,o,1",
        "1,o,o,o,o,o,o,o,o,o,o,o,o,o,o,o,o,o,o,o,o,o,1",
        "1,o,o,o,o,o,o,o,o,o,o,o,o,o,o,o,o,o,o,o,o,o,1",
        "1,o,o,o,o,o,o,o,o,o,o,o,o,o,o,o,o,o,o,o,o,o,1",
        "1,o,o,o,o,o,o,o,o,o,o,o,o,o,o,o,o,o,o,o,o,o,1",
        "1,1,1,1,1,1,1,1,1,1,1,o,1,1,1,1,1,1,1,1,1,1,1",
        "1,1,1,1,1,1,1,1,1,1,1,o,o,o,o,o,o,o,o,o,o,o,1",
        "1,o,o,o,o,o,o,o,o,o,o,o,o,o,o,o,o,o,o,o,o,o,1",
        "1,o,o,o,o,o,o,o,o,o,o,o,o,o,o,o,o,o,o,o,o,o,1",
        "1,o,o,o,o,o,o,o,o,o,o,o,o,o,o,o,o,o,o,o,o,o,1",
        "1,1,1,1,1,1,1,1,1,1,1,1,1,1,1,0,1,1,1,1,1,0,1",
        "1,1,1,o,o,o,o,o,o,o,o,o,Z,o,1,0,1,1,1,1,1,0,1",
        "1,1,1,o,o,o,o,o,Z,o,o,o,o,o,1,0,0,0,0,0,0,0,1",
        "1,1,1,o,o,o,o,o,1,1,0,1,o,o,1,1,1,1,0,1,1,1,1",
        "1,1,1,o,o,o,o,o,1,1,0,1,1,1,1,1,1,1,0,0,0,0,1",
        "1,1,1,1,1,1,1,o,1,1,0,0,0,0,0,1,1,1,1,1,1,0,1",
        "1,o,o,o,o,o,o,o,1,1,1,1,1,1,0,0,0,0,0,0,0,0,1",
        "1,o,o,o,o,o,o,o,1,1,1,1,1,1,1,1,1,1,0,1,o,o,1",
        "1,o,o,1,1,1,1,1,1,1,o,o,o,o,o,o,o,1,0,1,o,o,1",
        "1,o,o,o,o,o,o,o,o,o,o,o,o,o,o,o,o,1,0,1,o,o,1",
        "1,o,o,o,o,o,1,1,1,1,1,1,1,1,1,1,1,1,0,1,1,1,1",
        "1,1,1,1,1,o,o,o,o,o,o,o,o,o,o,o,Z,1,0,0,0,0,1",
        "1,1,1,1,1,1,1,1,1,1,0,1,0,1,1,1,1,1,1,1,1,0,1",
        "1,0,0,1,1,0,0,0,1,1,0,1,0,1,1,1,1,1,0,0,0,0,1",
        "1,0,0,1,1,0,1,0,0,0,0,1,0,0,0,0,0,0,0,1,1,1,1",
        "1,0,0,0,0,0,1,1,1,1,1,1,1,1,1,1,1,0,0,0,0,0,1",
        "1,1,1,0,1,0,1,1,0,0,0,0,1,1,1,1,1,1,1,1,1,0,1",
        "1,o,o,o,1,0,1,1,0,0,1,0,0,0,0,0,1,0,0,0,0,0,1",
        "1,o,o,o,0,0,0,0,0,0,1,1,1,0,1,o,o,o,Z,1,1,1,1",
        "1,1,o,1,1,1,1,1,1,0,1,0,0,0,1,0,1,0,0,0,0,0,1",
        "1,o,o,0,0,0,0,0,0,0,1,0,1,1,1,0,1,1,1,1,1,0,1",
        "1,o,o,1,1,0,1,1,1,0,1,0,1,0,0,0,1,0,0,0,1,0,1",
        "1,o,o,1,1,0,1,1,1,0,1,0,1,0,1,1,1,0,1,0,1,0,1",
        "1,o,o,1,1,0,1,1,1,0,1,0,1,0,0,0,0,0,1,0,1,0,1",
        "1,o,o,1,1,0,o,Z,o,0,1,0,1,1,1,1,1,1,1,0,1,0,1",
        "1,1,1,1,0,0,1,1,1,0,1,0,o,o,o,o,o,o,o,Z,1,0,1",
        "1,1,0,0,0,1,1,1,0,0,1,0,1,1,1,1,1,0,1,1,1,0,1",
        "1,0,0,1,1,1,1,1,0,0,0,0,1,0,0,0,0,0,1,0,0,0,1",
        "1,0,1,1,1,1,1,1,1,1,1,1,1,0,1,1,1,1,1,0,1,o,1",
        "1,0,0,0,0,0,0,0,0,0,0,0,1,0,0,0,0,0,1,0,1,o,1",
        "1,1,1,1,1,0,1,1,1,1,1,0,1,1,1,1,1,0,1,0,1,1,1",
        "1,1,0,0,0,0,1,1,1,o,o,0,o,o,1,1,1,0,1,0,0,0,1",
        "1,1,0,1,1,1,1,0,0,0,0,P,0,0,0,0,0,0,1,1,1,0,1",
        "1,1,0,0,0,0,0,0,1,1,1,1,1,1,1,1,1,0,0,0,0,0,1",
        "1,1,1,1,1,1,1,1,1,1,1,1,1,1,1,1,1,1,1,1,1,1,1"
    ]
}