{
    "nivel": 16,
    "nombre": "Nivel 16 - Espacios falsos",
    "mapa": [
        "1,1,1,1,1,1,1,1,1,1,1,1,1,1,1,1,1,1,1,1",
        "1,1,1,1,1,1,o,o,o,1,1,1,1,1,o,f,o,o,o,1",
        "1,o,o,o,o,o,o,1,o,o,o,o,o,1,o,1,o,S,o,1",
        "1,o,1,1,1,1,1,1,1,1,1,1,o,o,o,1,o,o,o,1",
        "1,o,o,o,o,o,o,1,1,1,1,1,1,1,1,1,1,o,1,1",
        "1,o,o,o,o,1,f,1,o,o,o,o,o,o,o,o,o,o,1,1",
        "1,1,1,1,1,1,o,1,1,1,f,1,1,1,1,1,o,o,1,1",
        "1,o,o,o,o,o,o,1,o,o,o,o,Z,1,o,1,o,1,o,1",
        "1,o,1,1,1,o,o,1,1,1,o,1,1,1,o,1,o,1,o,1",
        "1,o,o,o,1,1,1,1,1,1,o,1,o,o,o,o,o,o,o,1",
        "1,1,1,o,o,o,o,o,Z,1,f,1,1,1,1,1,1,W,o,1",
        "1,1,o,o,o,1,1,1,1,1,o,o,o,o,o,1,1,1,o,1",
        "1,1,f,1,1,1,o,o,o,o,o,1,1,1,o,1,o,f,o,1",
        "1,1,o,o,f,o,o,1,1,1,1,1,1,1,o,1,o,1,o,1",
        "1,1,o,o,1,1,1,1,1,1,1,o,o,o,o,1,o,1,o,1",
        "1,1,o,o,1,o,o,o,o,o,1,o,1,1,1,1,o,1,o,1",
        "1,1,1,o,o,o,1,1,1,o,1,o,o,o,o,o,o,1,o,1",
        "1,1,1,1,1,1,1,o,o,o,1,1,1,1,1,1,1,1,o,1",
        "1,o,o,o,o,o,o,o,1,1,1,o,o,o,o,o,o,f,o,1",
        "1,f,1,1,1,1,1,1,1,1,1,f,1,1,1,1,1,1,o,1",
        "1,o,1,1,1,o,o,o,o,o,1,o,o,o,o,o,o,1,1,1",
        "1,o,o,o,o,o,1,1,1,o,o,o,1,1,1,1,o,o,o,1",
        "1,1,1,1,1,1,1,1,1,o,1,1,1,1,1,1,1,1,o,1",
        "1,Z,o,o,o,o,o,o,1,o,o,o,o,o,o,o,o,f,o,1",
        "1,1,f,1,1,1,1,1,1,1,1,1,1,1,1,1,1,1,o,1",
        "1,1,o,o,o,o,1,1,1,1,o,o,o,o,o,o,o,1,o,1",
        "1,1,1,1,1,o,o,o,o,o,o,1,1,1,1,1,f,1,o,1",
        "1,o,o,o,1,1,1,1,1,1,1,1,o,o,o,o,o,1,o,1",
        "1,o,P,o,f,o,o,o,o,o,o,o,o,1,1,1,o,f,o,1",
        "1,1,1,1,1,1,1,1,1,1,1,1,1,1,1,1,1,1,1,1"
    ]
}