{
    "nivel": 18,
    "nombre": "Nivel 18",
    "mapa": [
        "1,1,1,1,1,1,1,1,1,1,1,1,1,1,1,1,1,1,1,1",
        "1,o,o,o,o,0,0,0,0,0,0,0,0,0,1,o,o,o,Z,1",
        "1,o,o,o,o,0,1,o,o,1,1,1,1,0,1,1,1,o,1,1",
        "1,1,1,1,1,0,1,0,0,0,0,0,1,0,0,0,0,0,1,1",
        "1,0,0,0,0,m,1,0,1,1,1,0,1,1,1,1,1,0,1,1",
        "1,0,1,1,1,1,1,0,1,1,1,0,1,1,o,m,1,0,1,1",
        "1,0,1,o,o,o,1,0,1,1,1,0,0,0,0,0,1,0,1,1",
        "1,0,0,o,o,o,1,0,m,1,1,1,1,1,1,0,1,0,1,1",
        "1,1,f,1,1,1,1,1,0,1,o,o,o,1,1,0,1,0,m,1",
        "1,o,0,o,o,o,o,o,o,1,o,o,o,0,0,0,1,1,0,1",
        "1,o,0,o,o,o,o,o,o,1,0,1,1,1,1,1,1,m,0,1",
        "1,1,0,1,1,1,1,o,S,1,0,1,0,0,0,0,1,0,1,1",
        "1,o,0,o,o,1,1,1,1,1,0,1,1,o,1,0,1,0,0,1",
        "1,o,0,o,Z,1,1,1,1,0,0,1,1,o,1,0,1,1,0,1",
        "1,o,0,o,o,1,0,0,0,0,1,1,1,o,1,0,0,0,m,1",
        "1,o,0,o,o,1,0,1,o,o,o,o,o,o,1,0,1,1,1,1",
        "1,o,0,o,Z,1,0,1,1,1,1,1,1,1,1,0,0,0,0,1",
        "1,o,0,o,o,1,0,0,0,0,0,0,0,0,0,1,1,1,0,1",
        "1,1,f,1,1,1,1,1,1,1,1,1,1,1,0,1,0,0,0,1",
        "1,1,m,1,0,0,0,0,0,0,0,0,1,o,o,1,0,1,1,1",
        "1,1,0,1,0,o,o,o,o,0,o,o,1,o,o,o,o,o,Z,1",
        "1,1,0,1,0,o,o,o,o,0,o,Z,1,o,o,o,o,o,o,1",
        "1,1,0,1,0,o,o,o,o,0,o,o,1,m,o,o,o,o,Z,1",
        "1,1,0,0,0,Z,o,o,o,0,o,o,1,1,1,1,1,1,1,1",
        "1,1,1,1,1,1,1,o,o,0,o,1,1,0,0,0,0,0,o,1",
        "1,1,m,0,0,0,1,1,1,0,0,0,0,0,0,0,0,0,o,1",
        "1,1,o,o,o,0,1,1,1,1,1,1,1,1,1,0,0,0,o,1",
        "1,o,o,o,o,0,o,o,o,o,o,o,o,o,o,o,o,0,1,1",
        "1,P,o,1,1,0,0,0,0,0,0,0,0,0,0,0,0,0,1,1",
        "1,1,1,1,1,1,1,1,1,1,1,1,1,1,1,1,1,1,1,1"
    ]
}